+++++++++++++++++++++
+   + +   +         +
+ + + + +++ +++++++ +
+%    +     +   +   +
+++++ + +++++ + + +++
+     +       + +   +
+ +++++++++ +++++++ +
+       +   +   +   +
+++++++ + +++ + + + +
+       + + + + + + +
+ +++++++ + + + + + +
+   + +     + +   + +
+++ + + +++++ + +++ +
+   +   $ +   + +   +
+ +++++++ + +++++ +++
+     +   +     + + +
+++++ + +++++ + + + +
+ +   + +   + + + + +
+ + + +++ + +++ + + +
+   +     +     +   +
+++++++++++++++++++++
